COINSSHOP : Coins Shop
FREE : FREE
BUYTIPS : Buy Tips
GETFREE : Get Free
DAILYREWARD : Daily Rewards
DAY : Day
THANKS : Thanks!
LOADING : Loading...
LUCKYSPIN : <sprite index=0 color=#FE96CD>  LUCKY SPIN  <sprite index=0 color=#FE96CD>
OK : OK
YOURWIN : Your WIN!
NOADSLABEL1 : Make this purchase to remove ads permanently
NOADSLABEL2 : Reward videos are optional and available for viewing after purchase
BUY : BUY
OUTOFLIVES : OUT OF LIVES
REFILLTHELIVES : Refill the lives?
OUTOFTIME : OUT OF TIME
REFILLTHETIME : Refill the time?
GIFT : Gift
LEVELCLEARED : LEVEL CLEARED!
SETTINGS : Settings
SHOP : SHOP
PRIVACY : PRIVACY
PRIVACYSETTINGS : Privacy Settings
QUITTHEGAME : Quit the game
DOYOUWANTTOQUIT : Do you really want to quit?
YES : Yes
NO : NO
COMINGSOON : Reset the game to play again or wait for the next update
YOUWIN : You WIN!
NEXTLEVEL : Next Level
SCORE : Score
POINTS : Points
REVIVEWITHNEWSHAPES : Continue with new shapes?
WHATCHADS : Watch Ads
CONTINUE : Continue
YOULOSE : You Lose...
RETRY : Retry
ALMOST : Almost there...
ARCADEMODE : ARCADE MODE
STAGE : STAGE {stage}
LEVEL : LEVEL {level}
MOSTPOPULAR : Most Popular
BESTOFFER : BEST Offer
NOADS : NO ADS
FREESPIN : FREE Spin
SOUNDS : Sounds
MUSIC : Music
VIBRATION : Vibration
GAMEOVER : Game Over
YOURSCORE : Your Score
BESTSCORE : BEST Score
NEWRECORD : New Record!
EXITGAME : Exit Game
ADVENTURE : ARCADE
CLASSIC : CLASSIC
TUTORIAL : Tutorial
RESTORE_PURCHASES : Restore Purchases
TIMED : TIMED
CONTINUEWITHEXTRASECONDS : EXTRA <color=yellow>+{continueTimerBonus}</color> sec
YOUHAVETIMELEFT : You have <color=yellow>{timeLeft}</color> min left
CONTINUEORLOSEPROGRESS : New shapes or lose progress?